00000000000000000000000000000000000000000000000000000000000000000000000000000000000000000000000000000000000000000000000000000
00000000000000000000000000000000000000000000000000000000000000000000000000000000000000000000000000000000000000000000000000000
00000000000000000000000000000000000000000000000000000000000000000000000000000000000000000000000000000000000000000000000000000
00000000000000000000000000000000000000000000000000000000000000000000000000000000000000000000000000000000000000000000000000000
00000000000000000000000000000000000000000000000000000000000000000000000000000000000000000000000000000000000000000000000000000
00000000000000000000000000000000000000000000000000000000000000000000000000000000000000000000000000000000000000000000000000000
00000000000000000000000000000000000000000000000000000000000000000000000000000000000000000000000000000000000000000000000000000
00000000000000000000000000000000000000000000000000000000000000000000000000000000000000000000000000000000000000000000000000000
00000000000001230123000000000000000000122222222223000000000000012222222222300000000000001222222222230000000000000122222222223
00000000000004560456000000000000000000455555555556000000000000045555555555600000000000004555555555560000000000000455555555556
00000000000000000000000000000000000000000000000000000000000000000000000000000000000000000000000000000000000000000000000000000
12222222222300000000000001222222222230000000000000122222222223000000000000012222222222300000000000001222222222230000000000000
45555555555600000000000004555555555560000000000000455555555556000000000000045555555555600000000000004555555555560000000000000
